########################################
#                                      #
#                                      #
#                                      #
#                                      #
#                                      #
#                                      #
#                                      #
#               #                      #
#               #                      #
#        P     <#                      #
#              <#                      #
#              <#      #               #
#      ##########      #>              #
#                      #>              #
#                      #               #
#                      #               #
#                      #######         #
#                     e#vvvvv#         #
#                                      #
#                               ###    #
#                               ###    #
#####^^^^^##############################
########################################
